escherichia coli	mlst:mlst|ecoli1,rep:repDB_1|GN,arm:armDB_1|GN,vir:virDB_B|enterob
shigella sonnei	mlst:mlst|ecoli1,rep:repDB_1|GN,arm:armDB_1|GN
salmonella enterica	mlst:mlst|salmonella,rep:repDB_1|GN,arm:armDB_1|GN
salmonella enteritidis	mlst:mlst|salmonella,rep:repDB_1|GN,arm:armDB_1|GN
klebsiella pneumoniae	mlst:mlst|kpneumoniae,rep:repDB_1|GN,arm:armDB_1|GN
klebsiella variicola	mlst:mlst|kpneumoniae,rep:repDB_1|GN,arm:armDB_1|GN
klebsiella oxytoca	mlst:mlst|koxytoca,rep:repDB_1|GN,arm:armDB_1|GN
enterobacter cloacae	mlst:mlst|ecloacae,rep:repDB_1|GN,arm:armDB_1|GN
citrobacter freundii	mlst:mlst|cfreundii,rep:repDB_1|GN,arm:armDB_1|GN
citrobacter sedlakii	rep:repDB_1|GN,arm:armDB_1|GN
enterobacter aerogenes	arm:armDB_1|GN,rep:repDB_1|GN
enterobacter amnigenus	arm:armDB_1|GN,rep:repDB_1|GN
citrobacter koseri	arm:armDB_1|GN,rep:repDB_1|GN
morganella morganii	arm:armDB_1|GN,rep:repDB_1|GN
proteus mirabilis	arm:armDB_1|GN,rep:repDB_1|GN
hafnia alvei	arm:armDB_1|GN,rep:repDB_1|GN
providencia rettgeri	arm:armDB_1|GN,vir:virDB_B|enterob,rep:repDB_1|GN
pseudomonas aeruginosa	mlst:mlst|paeruginosa,arm:armDB_1|GN,rep:repDB_1|GN
acinetobacter baumanii	mlst:mlst|abaumanii,arm:armDB_1|GN,rep:repDB_1|GN
staphylococcus aureus	mlst:mlst|saureus,arm:armDB_1|all,rep:repDB_1|GP
staphylococcus epidermidis	mlst:mlst|saureus,arm:armDB_1|all,rep:repDB_1|GP
enterococcus faecalis	mlst:mlst|efaecalis,arm:armDB_1|all,rep:repDB_1|GP
enterococcus faecium	mlst:mlst|efaecium,arm:armDB_1|all,rep:repDB_1|GP
dbDir	mlst:/usr/local/readmapper-v0.1/dbMLST,arm:/usr/local/readmapper-v0.1/dbARM,rep:/usr/local/readmapper-v0.1/dbREP,vir:/usr/local/readmapper-v0.1/dbVIR
